20,8,200,600,1600,400
01:05:05:05:05:05:05:05:05:05:05:05:05:05:05:05:01:01:05:01
01:05:05:05:05:05:05:05:05:05:05:05:05:05:05:05:01:01:05:01
01:05:05:05:05:05:05:05:05:05:05:05:03:05:05:05:01:01:05:01
01:05:05:05:05:05:05:05:05:05:05:01:01:05:01:05:01:01:05:01
01:05:05:05:05:05:05:05:05:05:03:03:03:05:01:05:01:01:05:01
01:05:05:01:01:01:05:05:05:01:01:01:01:05:01:05:01:01:05:01
01:05:05:01:04:03:05:05:03:03:03:03:03:05:05:05:01:05:06:01
01:02:02:02:02:02:02:02:02:02:02:02:02:02:02:02:02:02:02:02
Switch1,14,7-16,7:16,6-16,5
