20,8,200,600,1600,400
01:00:00:00:00:00:00:00:00:00:00:00:00:00:00:00:00:00:00:01
01:00:00:00:00:00:00:00:00:00:00:00:00:00:00:00:00:00:00:01
01:00:00:00:00:00:00:00:00:00:00:00:00:00:00:00:00:00:00:01
01:00:00:00:00:00:00:00:00:00:00:00:00:00:00:00:00:00:00:01
01:00:00:00:00:00:00:00:00:00:00:00:00:00:00:00:01:00:00:01
01:00:00:00:01:00:00:00:00:00:00:00:00:00:00:00:01:00:00:01
01:00:00:01:01:01:00:00:03:00:00:00:00:00:04:00:01:00:00:01
01:02:02:02:02:02:02:02:02:02:02:02:02:02:02:02:02:02:02:02
Switch1,14,7-16,7:16,6-16,5